########################
#                      #
# ######### ########## #
#                      #
# #################### #
#                      #
# ######### ########## #
#                      #
# #################### #
#                      #
# ######### ########## #
#          P           #
########################